YEAR,NAME,BIRTHS,DEATHS,NETMIG,POPEST,NATINC,NPOPCHG,RBIRTHS,RDEATHS,RNETMIG,RNATINC,RPOPCHG
2010,15-County Region,29733,16896,4624,2186769,12837,17461,13.596772224226703,7.726467679027826,2.1145351886733352,5.870304545198876,7.984839733872211
2011,15-County Region,29705,17067,7141,2206291,12638,19779,13.46377245793959,7.735606953026594,3.2366537324405527,5.7281655049129965,8.964819237353549
2012,15-County Region,30059,17666,6812,2225767,12393,19205,13.505007487306624,7.937039231869284,3.0605180146888693,5.567968255437339,8.628486270126208
2013,15-County Region,30594,17563,13895,2252245,13031,26926,13.583779739770764,7.7979971095506935,6.169399865467567,5.785782630220069,11.955182495687637
2014,15-County Region,30746,17974,14362,2279644,12772,27134,13.487193614441555,7.884564431990259,6.300106507858245,5.602629182451295,11.902735690309541
2015,15-County Region,31067,19181,13548,2304910,11886,25434,13.478617386362158,8.321799983513456,5.877886772151625,5.156817402848701,11.034704175000327
2016,15-County Region,30811,19140,12309,2329214,11671,23980,13.228067494013002,8.217364312596438,5.284615325169779,5.010703181416564,10.295318506586343
2017,15-County Region,30594,19999,19739,2360060,10595,30334,12.963229748396227,8.473937103293984,8.36377041261663,4.4892926451022435,12.853063057718872
2018,15-County Region,30280,20319,11555,2382390,9961,21516,12.709925746834061,8.528830292269529,4.850171466468547,4.1810954545645345,9.031266921033081
2019,15-County Region,30199,20491,7690,2400549,9708,17398,12.580038982749363,8.535964064886825,3.20343388116635,4.044074917862539,7.247508799028889
2020,15-County Region,28783,23562,3564,2422226,5221,8785,11.88287137533822,9.72741602146125,1.4713738519857353,2.1554553538769707,3.6268292058627063
2021,15-County Region,29233,24512,-569,2426372,4721,4152,12.048028909004886,10.102325612066082,-0.23450649776703655,1.9457032969388042,1.7111967991717676
2022,15-County Region,29100,23118,11314,2441273,5982,17296,11.9200105846417,9.469649645901953,4.634467345520144,2.4503609387397476,7.084828284259892
2023,15-County Region,28669,21815,11399,2459817,6854,18253,11.654932053888562,8.868545912155254,4.634084568079658,2.786386141733308,7.420470709812966
2010,Delaware,2178,911,2388,175099,1267,3655,12.438677548129915,5.202771003832118,13.637999074809109,7.235906544297798,20.873905619106907
2011,Delaware,2088,899,2259,178535,1189,3448,11.695185817906854,5.035427227154339,12.652981208166466,6.659758590752514,19.31273979891898
2012,Delaware,2084,989,1399,181127,1095,2494,11.505739067063441,5.460257167622718,7.723862262390477,6.045481899440723,13.769344161831201
2013,Delaware,2194,989,3030,185380,1205,4235,11.835149422807207,5.33498759305211,16.344805264861368,6.500161829755098,22.844967094616464
2014,Delaware,2213,1031,2777,189440,1182,3959,11.681798986486486,5.442356418918919,14.658994932432433,6.2394425675675675,20.8984375
2015,Delaware,2231,1069,2819,193391,1162,3981,11.53621419817882,5.5276615768055395,14.576686608994214,6.008552621373281,20.585239230367495
2016,Delaware,2123,1143,2696,197144,980,3676,10.768778152010713,5.797792476565353,13.675283041837439,4.97098567544536,18.646268717282798
2017,Delaware,2120,1165,2722,200870,955,3677,10.554089709762533,5.799770996166675,13.551052919798874,4.754318713595858,18.30537163339473
2018,Delaware,2127,1236,3276,205091,891,4167,10.371006041220726,6.026593073318673,15.973397174912598,4.344412967902053,20.31781014281465
2019,Delaware,2147,1279,3225,209177,868,4093,10.2640347648164,6.114438967955368,15.41756502865994,4.149595796861032,19.567160825520972
2020,Delaware,2014,1475,3528,215166,539,4067,9.360214903841685,6.855172285584154,16.396642592231114,2.5050426182575314,18.901685210488647
2021,Delaware,2201,1525,5672,221282,676,6348,9.946583996890844,6.891658607568623,25.63245089975687,3.0549253893222224,28.687376289079094
2022,Delaware,2176,1528,4599,226526,648,5247,9.60596134660039,6.745362563237774,20.30230525414301,2.860598783362616,23.162904037505626
2023,Delaware,2148,1586,4402,231636,562,4964,9.273169973579236,6.846949524253571,19.003954480305307,2.4262204493256663,21.430174929630972
2010,Fairfield,1642,1124,400,146417,518,918,11.21454475914682,7.676704207844717,2.7319232056386893,3.5378405513021027,6.269763756940792
2011,Fairfield,1678,1134,266,147174,544,810,11.401470368407463,7.705165314525663,1.807384456493674,3.6963050538817996,5.503689510375474
2012,Fairfield,1637,1182,-401,147301,455,54,11.113298619832861,8.024385442054026,-2.7223168885479394,3.088913177778834,0.3665962892308946
2013,Fairfield,1727,1168,959,148796,559,1518,11.606494798247265,7.849673378316622,6.445065727573322,3.7568214199306436,10.201887147503966
2014,Fairfield,1598,1191,1131,150360,407,1538,10.627826549614259,7.920989624900239,7.5219473264165995,2.7068369247140196,10.22878425113062
2015,Fairfield,1749,1316,493,151254,433,926,11.563330556547266,8.700596347865181,3.259417932748886,2.8627342086820846,6.122152141430971
2016,Fairfield,1679,1315,1101,152789,364,1465,10.989010989010989,8.606640530404677,7.20601613990536,2.3823704586063137,9.588386598511674
2017,Fairfield,1821,1397,1561,154686,424,1985,11.772235367130833,9.0311986863711,10.091410987419675,2.7410366807597324,12.832447668179409
2018,Fairfield,1719,1483,919,155982,236,1155,11.020502365657576,9.50750727648062,5.8917054531933175,1.5129950891769564,7.404700542370273
2019,Fairfield,1772,1469,1278,157574,303,1581,11.24551004607359,9.322603982890577,8.110475078375874,1.9229060631830124,10.033381141558886
2020,Fairfield,1642,1684,2080,159448,-42,2038,10.298028197280617,10.561436957503386,13.045005268175204,-0.26340876022276855,12.781596507952436
2021,Fairfield,1729,1818,1793,161209,-89,1704,10.725207649696976,11.277286007605035,11.122207817181422,-0.5520783579080573,10.570129459273366
2022,Fairfield,1743,1697,1922,162956,46,1968,10.696138835022952,10.413854046491078,11.7945948599622,0.28228478853187366,12.076879648494073
2023,Fairfield,1718,1554,2300,165360,164,2464,10.389453313981615,9.397677793904208,13.90904692791485,0.9917755200774068,14.900822447992258
2010,Fayette,340,334,8,29014,6,14,11.71848073343903,11.511684014613635,0.27572895843385953,0.20679671882539463,0.48252567725925416
2011,Fayette,369,357,-157,28867,12,-145,12.782762323760695,12.36706273599612,-5.438736273253196,0.41569958776457544,-5.02303668548862
2012,Fayette,380,343,-133,28767,37,-96,13.209580422011333,11.923384433552334,-4.623353147703966,1.2861959884589982,-3.3371571592449683
2013,Fayette,354,353,-65,28686,1,-64,12.340514536707802,12.30565432615213,-2.265913686118664,0.034860210555671754,-2.2310534755629923
2014,Fayette,326,351,-15,28650,-25,-40,11.37870855148342,12.251308900523561,-0.5235602094240838,-0.8726003490401396,-1.3961605584642234
2015,Fayette,365,372,-23,28611,-7,-30,12.757331096431443,13.001992240746565,-0.803886617035406,-0.24466114431512354,-1.0485477613505294
2016,Fayette,335,364,63,28670,-29,34,11.68468782699686,12.696198116498081,2.197418904778514,-1.0115102895012207,1.1859086152772933
2017,Fayette,304,409,56,28639,-105,-49,10.614895771500402,14.281224903104158,1.9553755368553372,-3.6663291316037574,-1.71095359474842
2018,Fayette,365,352,28,28653,13,41,12.738631207901442,12.284926534743308,0.9772100652636723,0.45370467315813356,1.4309147384218057
2019,Fayette,298,384,-147,28525,-86,-233,10.44697633654689,13.46187554776512,-5.153374233128835,-3.01489921121823,-8.168273444347065
2020,Fayette,338,396,116,28975,-58,58,11.665228645383952,13.66695427092321,4.003451251078515,-2.0017256255392577,2.0017256255392577
2021,Fayette,319,441,34,28934,-122,-88,11.025091587751433,15.241584295292734,1.1750881316098707,-4.216492707541301,-3.04140457593143
2022,Fayette,354,423,29,28832,-69,-40,12.278024417314095,14.671198668146504,1.005826859045505,-2.3931742508324083,-1.3873473917869035
2023,Fayette,301,406,64,28817,-105,-41,10.445223305687614,14.088905854183295,2.2209112676545093,-3.6436825484956796,-1.42277128084117
2010,Franklin,17851,8434,1200,1166202,9417,10617,15.30695368383865,7.23202326869616,1.0289812571064019,8.074930415142488,9.10391167224889
2011,Franklin,18046,8575,5322,1180800,9471,14793,15.282859078590786,7.262025745257453,4.507113821138211,8.020833333333334,12.527947154471546
2012,Franklin,18330,8732,8741,1199045,9598,18339,15.28716603630389,7.2824622929081055,7.28996826641202,8.004703743395785,15.294672009807805
2013,Franklin,18771,8881,10148,1218878,9890,20038,15.400228734951325,7.286209120190865,8.325689691667256,8.11401961476046,16.439709306427716
2014,Franklin,18880,9013,9496,1238362,9867,19363,15.245945854281704,7.2781626051186965,7.668193952979823,7.9677832491630065,15.63597720214283
2015,Franklin,19064,9636,9745,1257386,9428,19173,15.16161306074666,7.663517805987978,7.750205585237946,7.498095254758682,15.248300839996629
2016,Franklin,18955,9499,7485,1274450,9456,16941,14.873082506179136,7.453411275452155,5.873121738789282,7.41967123072698,13.292792969516261
2017,Franklin,18800,10035,11870,1295510,8765,20635,14.511659500891541,7.745984206991841,9.162414801892691,6.7656752938997,15.92809009579239
2018,Franklin,18266,10171,3659,1307698,8095,11754,13.968056844929027,7.777789673150834,2.798046643796962,6.190267171778193,8.988313815575156
2019,Franklin,18350,10162,628,1316756,8188,8816,13.935763345676799,7.71745106914265,0.4769296665441433,6.2183122765341485,6.695241943078292
2020,Franklin,17498,11879,-4696,1324441,5619,923,13.211611540264911,8.969066949754652,-3.545646804953939,4.242544590510261,0.6968977855563215
2021,Franklin,17368,11870,-12409,1317346,5498,-6911,13.184083756279671,9.010540890548118,-9.419696875384295,4.173542865731554,-5.2461540096527415
2022,Franklin,17425,11245,-184,1321730,6180,5996,13.18347922798151,8.507789034068985,-0.13921148797409455,4.675690193912524,4.536478705938429
2023,Franklin,17056,10669,-2527,1326063,6387,3860,12.862134001174905,8.045620758591408,-1.9056409838748234,4.816513242583497,2.9108722587086735
2010,Hocking,338,284,272,29478,54,326,11.466178166768437,9.634303548408983,9.227220299884658,1.8318746183594543,11.059094918244114
2011,Hocking,308,318,-14,29466,-10,-24,10.45272517477771,10.792099368764,-0.475123871580805,-0.33937419398628926,-0.8144980655670943
2012,Hocking,322,312,-174,29304,10,-164,10.988260988260988,10.647010647010648,-5.937755937755938,0.34125034125034126,-5.5965055965055965
2013,Hocking,322,315,-678,28653,7,-671,11.237915750532231,10.993613234216314,-23.662443723170348,0.24430251631591807,-23.418141206854433
2014,Hocking,302,306,85,28743,-4,81,10.50690602929409,10.646070347562885,2.9572417632119126,-0.13916431826879588,2.8180774449431167
2015,Hocking,325,265,-266,28500,60,-206,11.403508771929825,9.298245614035087,-9.333333333333334,2.1052631578947367,-7.228070175438597
2016,Hocking,299,303,-140,28393,-4,-144,10.530764625083647,10.671644419399147,-4.93079280104251,-0.1408797943155003,-5.07167259535801
2017,Hocking,316,336,81,28436,-20,61,11.11267407511605,11.816007877338585,2.848501899001266,-0.7033338022225348,2.145168096778731
2018,Hocking,286,360,-57,28357,-74,-131,10.085693126917516,12.695278061854216,-2.0100856931269178,-2.6095849349367,-4.619670628063617
2019,Hocking,312,344,-49,28264,-32,-81,11.038777243136146,12.170959524483441,-1.7336541183130485,-1.132182281347297,-2.8658363996603455
2020,Hocking,286,391,-68,28040,-105,-173,10.199714693295293,13.944365192582026,-2.425106990014265,-3.7446504992867333,-6.1697574893009985
2021,Hocking,272,437,212,28101,-165,47,9.679370840895341,15.551048005409061,7.544215508344899,-5.871677164513718,1.6725383438311805
2022,Hocking,277,400,-116,27818,-123,-239,9.957581422100798,14.379178948882018,-4.169961895175785,-4.421597526781221,-8.591559421957006
2023,Hocking,269,335,-153,27540,-66,-219,9.767610748002905,12.164124909222949,-5.555555555555555,-2.396514161220044,-7.9520697167756
2010,Knox,743,598,372,61090,145,517,12.16238336880013,9.78883614339499,6.08937633000491,2.3735472254051397,8.46292355541005
2011,Knox,684,648,133,61283,36,169,11.16133348563223,10.573894881125272,2.1702592888729337,0.5874386045069595,2.757697893379893
2012,Knox,771,624,-634,60764,147,-487,12.688433941149365,10.269238364821275,-10.433809492462641,2.419195576328089,-8.014613916134554
2013,Knox,711,566,-18,60858,145,127,11.682934043182492,9.300338492885077,-0.29577048210588586,2.3825955502974137,2.086825068191528
2014,Knox,709,563,30,61000,146,176,11.62295081967213,9.229508196721312,0.4918032786885246,2.3934426229508197,2.8852459016393444
2015,Knox,750,628,-140,61001,122,-18,12.294880411796528,10.294913198144293,-2.295044343535352,1.9999672136522353,-0.2950771298831167
2016,Knox,769,662,-213,60909,107,-106,12.625391978196983,10.868672938317818,-3.497020144806186,1.7567190398791641,-1.7403011049270223
2017,Knox,723,646,306,61271,77,383,11.8000359060567,10.54332392159423,4.9942060681235825,1.25671198446247,6.250918052586052
2018,Knox,778,649,485,61900,129,614,12.568659127625203,10.48465266558966,7.835218093699516,2.0840064620355414,9.919224555735056
2019,Knox,715,565,314,62322,150,464,11.472674176053399,9.065819453804435,5.0383492185745,2.406854722248965,7.445203940823465
2020,Knox,716,769,196,62803,-53,143,11.40072926452558,12.24463799500024,3.1208700221327006,-0.8439087304746589,2.2769612916580417
2021,Knox,784,815,-200,62543,-31,-231,12.535375661544858,13.031034648162064,-3.197799913659402,-0.49565898661720736,-3.69345890027661
2022,Knox,722,740,684,63196,-18,666,11.424773719855688,11.7096018735363,10.823469839863282,-0.2848281536806127,10.53864168618267
2023,Knox,702,709,86,63320,-7,79,11.086544535691724,11.197094125078964,1.3581806696146557,-0.11054958938723942,1.2476310802274162
2010,Licking,1991,1458,408,166705,533,941,11.943253051798086,8.745988422662787,2.447437089469422,3.1972646291352986,5.64470171860472
2011,Licking,1927,1428,-33,167164,499,466,11.52760163671604,8.542509152688378,-0.1974109257974205,2.985092484027662,2.787681558230241
2012,Licking,1954,1555,6,167589,399,405,11.659476457285383,9.278651940163137,0.035801872437928504,2.3808245171222455,2.416626389560174
2013,Licking,1901,1468,454,168461,433,887,11.284510955057847,8.714183104694854,2.6949857830595803,2.570327850362992,5.265313633422572
2014,Licking,2086,1550,529,169410,536,1065,12.313322708222655,9.149400861814533,3.1226019715483146,3.1639218464081225,6.2865238179564376
2015,Licking,1885,1701,894,170611,184,1078,11.048525593308756,9.970048824518935,5.239990387489669,1.0784767687898202,6.31846715627949
2016,Licking,2101,1574,1011,171993,527,1538,12.215613426127808,9.151535236899177,5.878146203624566,3.0640781892286313,8.942224392853198
2017,Licking,1900,1705,1274,173617,195,1469,10.943628792111372,9.8204668897631,7.337991095342047,1.1231619023482724,8.461152997690318
2018,Licking,2009,1754,1736,175666,255,1991,11.436476039757267,9.984857627543178,9.882390445504537,1.451618412214088,11.334008857718626
2019,Licking,2004,1801,943,176862,203,1146,11.33086813447773,10.183080593909375,5.331840644118013,1.1477875405683529,6.479628184686366
2020,Licking,1848,1953,828,178784,-105,723,10.336495435833184,10.923796312869161,4.631286916055128,-0.5873008770359764,4.043986039019152
2021,Licking,1961,2178,1341,180021,-217,1124,10.893173574194122,12.098588498008567,7.449130934724283,-1.205414923814444,6.243716010909838
2022,Licking,1891,1987,2002,181765,-96,1906,10.40354303633813,10.931697521525047,11.014221659835503,-0.5281544851869172,10.486067174648586
2023,Licking,1842,1861,1433,183201,-19,1414,10.054530270031277,10.158241494314987,7.822009705187199,-0.10371122428371024,7.7182984809034885
2010,Logan,559,469,-320,45743,90,-230,12.220449030452746,10.252934875281463,-6.99560588505345,1.967514155171283,-5.028091729882168
2011,Logan,536,423,-256,45623,113,-143,11.748460206474805,9.271639304736647,-5.611204874734235,2.4768209017381584,-3.1343839729960767
2012,Logan,537,456,-297,45410,81,-216,11.825589077295751,10.041841004184102,-6.540409601409381,1.7837480731116495,-4.756661528297732
2013,Logan,570,480,-100,45393,90,-10,12.55700218095301,10.574317626065692,-2.202982838763686,1.9826845548873173,-0.2202982838763686
2014,Logan,532,499,12,45473,33,45,11.69925010445759,10.973544740835221,0.2638928594990434,0.7257053636223694,0.9895982231214128
2015,Logan,581,511,-238,45250,70,-168,12.839779005524862,11.292817679558011,-5.259668508287293,1.5469613259668509,-3.712707182320442
2016,Logan,501,503,-168,45128,-2,-170,11.101755007977308,11.146073391242687,-3.722744194291792,-0.04431838326537848,-3.7670625775571707
2017,Logan,533,504,88,45198,29,117,11.792557192796142,11.150935882118677,1.9469888048143722,0.6416213106774636,2.5886101154918357
2018,Logan,566,509,53,45332,57,110,12.485661342980675,11.228271419747639,1.1691520338833494,1.2573899232330363,2.4265419571163855
2019,Logan,535,503,292,45672,32,324,11.71396041338238,11.01331231389035,6.393413907864775,0.7006480994920302,7.094062007356806
2020,Logan,486,572,-256,46116,-86,-342,10.53864168618267,12.403504206782895,-5.5512186659727645,-1.8648625206002256,-7.41608118657299
2021,Logan,541,624,88,46158,-83,5,11.720611811603622,13.518783309502144,1.9064950821092768,-1.7981714978985224,0.10832358421075436
2022,Logan,497,550,26,46062,-53,-27,10.789805045373628,11.940428118622727,0.5644566019712561,-1.1506230732490992,-0.5861664712778429
2023,Logan,505,544,10,46057,-39,-29,10.964674208046551,11.811451028073908,0.21712226154547626,-0.8467768200273573,-0.6296545584818811
2010,Madison,418,382,120,43434,36,156,9.623797025371829,8.794953262421146,2.762812543168946,0.8288437629506838,3.59165630611963
2011,Madison,424,365,-375,43114,59,-316,9.834392540706036,8.46592754093798,-8.697870761237649,1.368464999768057,-7.329405761469593
2012,Madison,425,406,-180,42991,19,-161,9.88579004908004,9.443837082179991,-4.1869228443162525,0.44195296690004887,-3.7449698774162035
2013,Madison,422,397,297,43256,25,322,9.755872017754763,9.177917514333272,6.866099500647309,0.5779545034214907,7.4440540040688
2014,Madison,430,376,657,43980,54,711,9.777171441564349,8.549340609367896,14.938608458390178,1.227830832196453,16.16643929058663
2015,Madison,407,423,142,44139,-16,126,9.220870432044224,9.583361652959967,3.217109585627223,-0.36249122091574343,2.8546183647114796
2016,Madison,414,448,-749,43377,-34,-783,9.544228508195587,10.328054037854162,-17.267215344537426,-0.7838255296585748,-18.051040874196
2017,Madison,445,445,672,44041,0,672,10.104221066733272,10.104221066733272,15.258509116505076,0.0,15.258509116505076
2018,Madison,431,405,330,44389,26,356,9.709612741895514,9.123882042848454,7.434274257135776,0.5857306990470612,8.020004956182838
2019,Madison,460,439,295,44731,21,316,10.283695870872549,9.814222798506629,6.594978873711743,0.46947307236592073,7.064451946077664
2020,Madison,433,473,-12,43849,-40,-52,9.87479760085749,10.787019088234624,-0.27366644621314057,-0.9122214873771353,-1.1858879335902759
2021,Madison,425,557,673,44428,-132,541,9.566039434590799,12.537138741334294,15.148104798775547,-2.971099306743495,12.177005492032052
2022,Madison,473,456,-823,43581,17,-806,10.853353525618962,10.46327528051215,-18.884376218994515,0.39007824510681255,-18.4942979738877
2023,Madison,432,457,1038,44602,-25,1013,9.685664319985651,10.246177301466302,23.272498991076635,-0.5605129814806511,22.711986009595982
2010,Marion,811,655,-184,66458,156,-28,12.203196003490927,9.855848806765175,-2.7686659243431944,2.3473471967257518,-0.4213187276174426
2011,Marion,776,643,-43,66599,133,90,11.651826604003062,9.65479962161594,-0.6456553401702728,1.9970269823871227,1.35137164221685
2012,Marion,790,712,-402,66277,78,-324,11.919670473920062,10.742791617001373,-6.065452570273247,1.1768788569186897,-4.888573713354558
2013,Marion,773,705,-380,65964,68,-312,11.718513128373052,10.687647807895216,-5.760717967376145,1.0308653204778364,-4.729852646898308
2014,Marion,709,733,-235,65791,-24,-259,10.77654998404037,11.141341520876717,-3.571917131522549,-0.3647915368363454,-3.9367086683588943
2015,Marion,735,758,-329,65431,-23,-352,11.233207501031622,11.584722837798598,-5.028197643318916,-0.35151533676697594,-5.379712980085892
2016,Marion,763,787,43,65467,-24,19,11.654726808926634,12.021323720347656,0.6568194662959965,-0.3665969114210213,0.29022255487497517
2017,Marion,747,763,-335,65076,-16,-351,11.478886225336531,11.724752596963551,-5.147827155940747,-0.24586637162702074,-5.393693527567767
2018,Marion,737,790,349,65427,-53,296,11.26446268360157,12.074525807388385,5.3341892490867675,-0.8100631237868158,4.5241261252999525
2019,Marion,740,814,-336,65093,-74,-410,11.36834989937474,12.505184889312215,-5.161845359716098,-1.1368349899374741,-6.298680349653572
2020,Marion,683,842,180,65388,-159,21,10.445341652902673,12.876980485716032,2.752798678656634,-2.43163883281336,0.32115984584327395
2021,Marion,708,934,69,65310,-226,-157,10.840606338998622,14.301025876588577,1.056499770326137,-3.4604195375899556,-2.403919767263819
2022,Marion,734,869,-482,64609,-135,-617,11.360646349579781,13.450138525592411,-7.460260954356205,-2.08949217601263,-9.549753130368835
2023,Marion,700,840,359,64851,-140,219,10.793973878583214,12.952768654299856,5.53576660344482,-2.158794775716643,3.376971827728177
2010,Morrow,389,304,-132,34790,85,-47,11.181373958033918,8.738143144581777,-3.7941937338315608,2.4432308134521414,-1.3509629203794193
2011,Morrow,409,312,-38,34810,97,59,11.749497270899166,8.962941683424303,-1.0916403332375753,2.7865555874748633,1.694915254237288
2012,Morrow,398,298,-86,34834,100,14,11.42561864844692,8.55486019406327,-2.468852270769937,2.870758454383648,0.4019061836137107
2013,Morrow,368,295,-64,34846,73,9,10.560753027607188,8.4658210411525,-1.8366527004534239,2.0949319864546867,0.2582792860012627
2014,Morrow,379,320,18,34937,59,77,10.848098004980393,9.159343961988723,0.5152130978618656,1.6887540429916708,2.2039671408535364
2015,Morrow,396,350,-31,34943,46,15,11.332741893941563,10.016312279998855,-0.8871590876570415,1.3164296139427067,0.42927052628566525
2016,Morrow,357,321,-61,34922,36,-25,10.222782200332169,9.191913407021362,-1.7467498997766453,1.030868793310807,-0.7158811064658382
2017,Morrow,359,351,-39,34911,8,-31,10.2832917991464,10.05413766434648,-1.117126407149609,0.22915413479991978,-0.8879722723496892
2018,Morrow,396,312,138,35113,84,222,11.277874291572921,8.885597926693817,3.9301683137299577,2.3922763648791046,6.322444678609062
2019,Morrow,368,342,151,35328,26,177,10.416666666666666,9.680706521739129,4.274230072463768,0.7359601449275361,5.010190217391304
2020,Morrow,350,380,48,34980,-30,18,10.005717552887365,10.863350485991996,1.37221269296741,-0.8576329331046313,0.5145797598627788
2021,Morrow,389,416,241,35205,-27,214,11.049566822894477,11.816503337594092,6.845618520096577,-0.7669365146996165,6.078682005396961
2022,Morrow,365,392,187,35336,-27,160,10.32940910119991,11.093502377179082,5.292053429929817,-0.7640932759791714,4.527960153950645
2023,Morrow,414,377,280,35595,37,317,11.630847029077119,10.591375193145105,7.866273352999017,1.039471835932013,8.90574518893103
2010,Perry,444,314,-12,36037,130,118,12.32067042206621,8.713266920109888,-0.33299109248827596,3.607403501956323,3.274412409468047
2011,Perry,438,344,60,36232,94,154,12.088761315963788,9.494369618017222,1.6559947008169573,2.5943916979465667,4.250386398763524
2012,Perry,391,341,-297,35984,50,-247,10.86594041796354,9.476433970653623,-8.253668297020898,1.3895064473099155,-6.864161849710983
2013,Perry,458,324,-101,36000,134,33,12.722222222222221,9.0,-2.8055555555555554,3.7222222222222223,0.9166666666666666
2014,Perry,431,366,-133,35926,65,-68,11.996882480654678,10.187607860602348,-3.7020542225686133,1.8092746200523298,-1.8927796025162833
2015,Perry,444,328,-21,35967,116,95,12.344649261823339,9.119470625851475,-0.5838685461673201,3.2251786359718633,2.641310089804543
2016,Perry,410,362,-63,35998,48,-15,11.389521640091116,10.056114228568255,-1.750097227623757,1.3334074115228625,-0.4166898161008945
2017,Perry,420,366,-86,35972,54,-32,11.675747803847436,10.174580229067052,-2.3907483598354276,1.5011675747803848,-0.8895807850550428
2018,Perry,408,360,3,36039,48,51,11.321068842087739,9.989178390077416,0.08324315325064513,1.331890452010322,1.4151336052609673
2019,Perry,416,394,46,36134,22,68,11.512702717662036,10.903857862401063,1.273039242818398,0.608844855260973,1.8818840980793712
2020,Perry,416,446,88,35446,-30,58,11.736162049314451,12.582519889409243,2.482649664278057,-0.8463578400947921,1.6362918241832647
2021,Perry,375,491,74,35464,-116,-42,10.5741033160388,13.845025941800136,2.0866230543649897,-3.2709226257613357,-1.1842995713963456
2022,Perry,381,436,127,35471,-55,72,10.741168842152746,12.291731273434637,3.5803896140509153,-1.5505624312818924,2.0298271827690226
2023,Perry,413,443,133,35551,-30,103,11.617113442659841,12.460971561981378,3.7411043289921517,-0.843858119321538,2.8972462096706137
2010,Pickaway,632,500,-76,55740,132,56,11.338356655902404,8.970218873340508,-1.3634732687477573,2.3681377825618943,1.004664513814137
2011,Pickaway,553,490,118,55948,63,181,9.884178165439337,8.758132551655109,2.1091013083577606,1.1260456137842283,3.235146922141989
2012,Pickaway,627,531,212,56237,96,308,11.149243380692427,9.442182193217988,3.769760122339385,1.7070611874744386,5.476821309813824
2013,Pickaway,593,503,58,56355,90,148,10.522580072753083,8.925561174696123,1.0291899565255966,1.5970188980569604,2.6262088545825573
2014,Pickaway,616,504,232,56704,112,344,10.863431151241535,8.888261851015802,4.091422121896162,1.9751693002257336,6.066591422121896
2015,Pickaway,629,562,155,56989,67,222,11.037217708680624,9.8615522293776,2.719823123760726,1.1756654793030235,3.8954886030637494
2016,Pickaway,604,603,539,57545,1,540,10.496133460769832,10.478755756364585,9.366582674428708,0.017377704405248065,9.383960378833956
2017,Pickaway,580,666,254,57740,-86,168,10.045029442327676,11.534464842396952,4.399030135088327,-1.489435400069276,2.9095947350190507
2018,Pickaway,637,615,347,58077,22,369,10.968197393116036,10.589389947827884,5.974826523408579,0.37880744528815197,6.35363396869673
2019,Pickaway,587,643,366,58457,-56,310,10.041569016542073,10.999538122038421,6.2610123680654155,-0.9579691054963477,5.3030432625690676
2020,Pickaway,633,719,484,58656,-86,398,10.791734860883798,12.257910529187125,8.251500272776868,-1.466175668303328,6.785324604473541
2021,Pickaway,622,767,200,58765,-145,55,10.584531608950906,13.051986726793158,3.4033863694375905,-2.467455117842253,0.9359312515953373
2022,Pickaway,631,713,1340,60007,-82,1258,10.515439865349043,11.881947106170948,22.330728081723798,-1.3665072408219041,20.964220840901895
2023,Pickaway,629,629,1155,61086,0,1155,10.296958386537014,10.296958386537014,18.907769374324722,0.0,18.907769374324722
2010,Ross,799,810,80,78098,-11,69,10.230735742272529,10.371584419575406,1.0243540167481882,-0.14084867730287587,0.8835053394453123
2011,Ross,861,805,-459,77581,56,-403,11.09807813768835,10.376251917350897,-5.916397055980201,0.7218262203374537,-5.194570835642748
2012,Ross,829,851,-334,77341,-22,-356,10.718764950026507,11.003219508410805,-4.3185373863797984,-0.2844545583842981,-4.6029919447640975
2013,Ross,827,762,-34,77283,65,31,10.700930346906823,9.859865688443772,-0.4399415136575961,0.8410646584630513,0.40112314480545525
2014,Ross,898,812,-333,77095,86,-247,11.64796679421493,10.532459952007263,-4.3193462611064275,1.115506842207666,-3.2038394188987613
2015,Ross,847,870,12,77049,-23,-11,10.993004451712546,11.291515788653973,0.15574504536074446,-0.29851133694142684,-0.1427662915806824
2016,Ross,834,889,-141,76848,-55,-196,10.8525921299188,11.568290651676035,-1.834790755777639,-0.715698521757235,-2.550489277534874
2017,Ross,862,811,387,77295,51,438,11.15207969467624,10.492269875153632,5.00679215990685,0.6598098195226082,5.666601979429458
2018,Ross,849,905,-411,76884,-56,-467,11.042609645700015,11.770979657666095,-5.345715623536757,-0.7283700119660788,-6.074085635502835
2019,Ross,786,929,-211,76666,-143,-354,10.252263063157072,12.117496673884121,-2.752197845198654,-1.86523361072705,-4.617431455925704
2020,Ross,745,1095,24,77049,-350,-326,9.669171566146218,14.21173538916793,0.3114900907214889,-4.542563823021713,-4.231073732300224
2021,Ross,833,1146,-234,76500,-313,-547,10.88888888888889,14.980392156862745,-3.0588235294117645,-4.091503267973856,-7.150326797385621
2022,Ross,708,1138,442,76508,-430,12,9.253934229100226,14.874261515135673,5.777173628901553,-5.620327286035447,0.15684634286610552
2023,Ross,709,944,282,76501,-235,47,9.26785270780774,12.339707977673493,3.6862263238389037,-3.071855269865753,0.6143710539731506
2010,Union,598,319,100,52464,279,379,11.398292162244587,6.080359865812748,1.906068923452272,5.317932296431839,7.224001219884111
2011,Union,608,326,358,53095,282,640,11.451172426782183,6.13993784725492,6.742631132875036,5.311234579527262,12.053865712402297
2012,Union,584,334,-608,52796,250,-358,11.061444048791575,6.3262368361239485,-11.516023941207667,4.735207212667627,-6.780816728540041
2013,Union,603,357,389,53436,246,635,11.28452728497642,6.680889288120368,7.279736507223594,4.603637996856052,11.883374504079647
2014,Union,637,359,111,53773,278,389,11.846093764528666,6.676212969334052,2.064232979376267,5.169880795194614,7.234113774570881
2015,Union,659,392,336,54388,267,603,12.116643377215564,7.207472236522762,6.1778333455909396,4.9091711406928,11.087004486283739
2016,Union,667,367,906,55581,300,1206,12.000503769273672,6.602975837066623,16.300534355265288,5.397527932207049,21.698062287472336
2017,Union,664,400,928,56798,264,1192,11.690552484242403,7.0425014965315675,16.33860347195324,4.6480509877108345,20.986654459664074
2018,Union,706,418,700,57782,288,988,12.218337890692604,7.234086739815168,12.114499325049325,4.984251150877436,17.09875047592676
2019,Union,709,423,895,58988,286,1181,12.019393775005085,7.170950023733641,15.172577473384417,4.848443751271445,20.02102122465586
2020,Union,695,488,1024,63085,207,1231,11.01688198462392,7.735594832369026,16.23206784497107,3.2812871522548943,19.513354997225964
2021,Union,706,493,1877,65106,213,2090,10.843854637053422,7.572266764967899,28.829908149786505,3.2715878720855223,32.10149602187202
2022,Union,723,544,1561,66876,179,1740,10.811053292661043,8.13445780250015,23.34170703989473,2.676595490160895,26.018302530055625
2023,Union,831,461,2537,69637,370,2907,11.933311314387467,6.620043942157187,36.43178195499519,5.31326737223028,41.745049327225466
